
C 225,30,0

F 220,-100,0
NO /Users/kprzybyl/42_projects/cub3D/textures/NO.xpm
SO /Users/kprzybyl/42_projects/cub3D/textures/SO.xpm
WE /Users/kprzybyl/42_projects/cub3D/textures/WE.xpm
EA /Users/kprzybyl/42_projects/cub3D/textures/EA.xpm

        1111111111111111111111111
        1000000000110000000000001
        1011000001110000000000001
        1001000000000000000000001
 11111111011000001110000000000001
100000000011000001110111111111111
1110111111111011111000010001
11110111111111011101010010001
1111111   1111111111111111111111
1100000111010101110000W010001
10000000000000001100000010001
1000000000000000111010010001  1
110000011101010111110111100111
11110111 1110101 101111010001         1
11111111 1111111 11111111111