
C 153,255,255

F 100,100,100
NO ./textures/NO.xpm
SO ./textures/SO.xpm
WE ./textures/WE.xpm
EA ./textures/EA.xpm

        111111111111111111111111
        10000S0000110000000000001
        1011000001110000000000001
        1001000000000000000000001
 11111111011000001110000000000001
100000000011000001110111111111111
1110111111111011111000010001
11110111111111011101010010001
1111111   1111111111111111111111
11000001110101011100000010001
10000000000000001100000010001
1000000000000000111010010001  1
110000011101010111110111100111
11110111 1110101 101111010001         1
1 111111 1111111 11111111111