
C 225,30,0

F 220,-100,0
NO /Users/kprzybyl/42_projects/cub3D/textures/NO.xpm
SO /Users/kprzybyl/42_projects/cub3D/textures/SO.xpm
WE /Users/kprzybyl/42_projects/cub3D/textures/WE.xpm
EA /Users/kprzybyl/42_projects/cub3D/textures/EA.xpm

        1111111111111111111111111
        1000000000110000000000001
        1011000001110000000000001
        1001000000000000000000001
111111111011000001110000000000001
100000000011000001110111111111111
11110111111111011111000010001
11110111111111011101010010001
11111111111111111111111111111
11000000110101011100000010001
10000000000000001100000010001
10000000000000001101010010001  1
11000001110101011111011110N0111
11110111 1110101 101111010001
11111111 1111111 111111111111